         6
##############################################################################
#########          ##########          ##########          ##########       ##
#####                ######              ######              ######          #
###                                                                          #
##         ######              ######              ######              #######
#        ##########          ##########          ##########          #########
        ######################################################################
        ######################################################################
#        ##########          ##########          ##########          #########
##         ######              ######              ######                #####
###                                                                        ###
######               ######              ######              ######         ##
#########          ##########          ##########          ##########        #
######################################################################        
######################################################################        
#########          ##########          ##########          ##########        #
#######              ######              ######              ######         ##
#                                                                          ###
#          ######              ######              ######                #####
##       ##########          ##########          ##########          #########
##############################################################################
        The        
       Snake       
