         5
#########################   #   #   #   #   #   #   ##########################
######################### # # # # # # # # # # # # # ##                       #
######################### # # # # # # # # # # # # # ## ##################### #
######################### # # # # # # # # # # # # # ## ##################### #
######################### # # # # # # # # # # # # # ## ##################### #
######################### # # # # # # # # # # # # # ## ##################### #
######################### # # # # # # # # # # # # # ## ##################### #
######################### # # # # # # # # # # # # # ## ##################### #
######################### # # # # # # # # # # # # # ## ##################### #
                                                                              
 #####################                                 ###################### 
                                                                              
# #################### ## # # # # # # # # # # # # # ##########################
# #################### ## # # # # # # # # # # # # # ##########################
# #################### ## # # # # # # # # # # # # # ##########################
# #################### ## # # # # # # # # # # # # # ##########################
# #################### ## # # # # # # # # # # # # # ##########################
# #################### ## # # # # # # # # # # # # # ##########################
# #################### ## # # # # # # # # # # # # # ##########################
#                      ## # # # # # # # # # # # # # ##########################
#########################   #   #   #   #   #   #   ##########################
     Mission:      
    Impossible     
