         6
##############################################################################
######                                #                                 ######
###### ############################## # ############################### ######
######      #########             ### # ###             ##########      ######
########### #########   ######    ### # ###    ######   ########## ###########
######      #########   ######    ### # ###    ######   ##########      ######
###### ##############             ### # ###             ############### ######
######             ##            #### # ####            ##              ######
################## ##            ##   #   ##            ## ###################
######                           ##       ##                            ######
###### ############################### ################################ ######
######                           ##       ##                            ######
################## ##            ##   #   ##            ## ###################
######             ##            #### # ####            ##              ######
###### ##############             ### # ###             ############### ######
######      #########   ######    ### # ###    ######   ##########      ######
########### #########   ######    ### # ###    ######   ########## ###########
######      #########             ### # ###             ##########      ######
###### ############################## # ############################### ######
######                                #                                 ######
##############################################################################
        The        
       Crypt       
