         5
##############################################################################
####                              #########                               ####
####                            # #   #   # #                             ####
####                            # # # # # # #                             ####
####                            # # # # # # #                             ####
####                            # # #   # # #                             ####
####                            #   #####   #                             ####
####                            #############                             ####
######################################################################### ####
#####################################   ################################# ####
####                                                                      ####
#### ################################   ######################################
#### #########################################################################
####                            #############                             ####
####                            #   #####   #                             ####
####                            # # #   # # #                             ####
####                            # # # # # # #                             ####
####                            # # # # # # #                             ####
####                            # # # # # # #                             ####
####                              #   #   #                               ####
##############################################################################
      Simple       
      Right?       
