         5
##############           #########################           #################
#               #### ##                             #### ##                  #
# ################   ################   ##############   ################### #
# ################ # ################ # ############## # ################### #
# ############   # # #   ############ # ##########   # # #   ############### #
# ############ # # # # # ############ # ########## # # # # # ############### #
# ########   # # # # # # #   ######## # ######   # # # # # # #   ########### #
# ######## # # # # # # # # # ######## # ###### # # # # # # # # # ########### #
# ####   # # # # # # # # # # #   #### # ##   # # # # # # # # # # #   ####### #
#  ### # # # # # # # # # # # # # ###  #  # # # # # # # # # # # # # # ######  #
#      # # # # # # # # # # # # # #         # # # # # # # # # # # # # #       #
#  ##### # # # # # # # # # # # # # #  #  ### # # # # # # # # # # # # # ####  #
# ######   # # # # # # # # # # #   ## # ####   # # # # # # # # # # #   ##### #
# ########## # # # # # # # # # ###### # ######## # # # # # # # # # ######### #
# ##########   # # # # # # #   ###### # ########   # # # # # # #   ######### #
# ############## # # # # # ########## # ############ # # # # # ############# #
# ##############   # # #   ########## # ############   # # #   ############# #
# ################## # ############## # ################ # ################# #
# ##################   ##############   ################   ################# #
#                 ## ####                             ## ####                #
################           #########################           ###############
        The        
       Mazer       
